111111111111111
1C00000000000C1
10P11100C000001
1C00011000000C1
111111111111111