111111111111111111111111
100100100000010100000001
111111100010001011111001
1P00000001100000000000E1
100100111100100111000001
100000010000000100010001
111111111111111111111111