111111111111111
1C00000000000C1
10011100C010001
1C00011E00000C1
111111111111111