111111111111111
100000000000001
1000000C00000E1
100000C0C000001
10CCCC000CCCC01
100C000P000C001
1000C00000C0001
100C000C000C001
10CCCCC0CCCCC01
100000000000001
111111111111111
